Add=添加控件
BackColorChanged=背景色改变
BackImageChanged=背景图片改变
Char=输入字符
CheckedChanged=选中状态改变
Click=鼠标点击
Copy=复制
Cut=剪切
DockChanged=绑定边缘改变
DoubleClick=鼠标双击
DragBegin=拖动开始
DragEnd=拖动结束
Dragging=拖动中
EnableChanged=可用状态改变
FontChanged=字体改变
TextColorChanged=前景色改变
GotFocus=获取焦点
GridCellClick=点击单元格
GridCellEditBegin=单元格编辑开始
GridCellEditEnd=单元格编辑结束
GridCellTouchDown=单元格鼠标按下
GridCellTouchMove=单元格鼠标移动
GridCellTouchUp=单元格鼠标抬起
GridSelectedCellsChanged=单元格选中改变
GridSelectedColumnsChanged=列选中改变
GridSelectedRowsChanged=行选中改变
Invoke=调用主线程方法
KeyDown=键盘按下
KeyUp=键盘抬起
Load=初始化控件
LocationChanged=位置改变
LostFocus=丢失焦点
MarginChanged=外边距改变
TouchDown=鼠标按下
TouchEnter=鼠标进入
TouchLeave=鼠标离开
TouchMove=鼠标移动
TouchUp=鼠标抬起
TouchWheel=鼠标滚动
PaddingChanged=内边距改变
Paint=重绘
PaintBorder=重绘边线
ParentChanged=父容器改变
Paste=粘贴
RegionChanged=区域改变
Remove=移除控件
SelectedIndexChanged=选中索引改变
SelectedTabPageChanged=选中页改变
SelectedTimeChanged=选中时间改变
SizeChanged=尺寸改变
TabIndexChanged=Tab索引改变
TabStop=被Tab切换
TabStopChanged=允许Tab改变
TextChanged=文本改变
Timer=秒表
ValueChanged=数值改变
VisibleChanged=可见状态改变
WindowClosed=窗体已被关系
WindowClosing=窗体被关闭中