ActiveLinkColor=激活链接时的颜色
Align=横向排列方式
AllowDrag=是否允许拖动
AllowDragRow=是否允许拖动行
AllowDragScroll=是否允许拖拽滚动
AllowHoveredRow=是否允许显示悬停行
AllowPreviewsEvent=是否允许预处理事件
AllowSort=是否允许排序
Anchor=锚定边缘配置
AutoEllipsis=超出部分显示圆点
AutoFormat=是否自动格式化
AutoSize=是否自动计算尺寸
AutoWrap=是否允许自动换行或换列
BackColor=背景色
BackImage=背景图片
BorderColor=边线色
BorderWidth=边线的宽度
Bounds=所在区域
ButtonAlign=按钮的横向排列方式
ButtonBackColor=按钮的背景色
ButtonBorderColor=按钮的边线颜色
ButtonSize=按钮的大小
CanDragSplitter=是否允许拖动分割线
CanFocus=是否允许获取焦点
CanRaiseEvents=是否允许触发事件
CanResize=是否允许拖拉改变尺寸
CaptionHeight=标题的高度
CellAlign=单元格内容排列方式
CellEditMode=单元格编辑模式
CheckBoxes=是否显示复选框
CheckBoxSize=复选框的大小
Checked=是否处于选中状态
CheckedBackImage=选中时的背景图片
CheckedImage=选中时的图片
CheckHoveredBackImage=鼠标悬停且选中时的背景图片
CheckPushedBackImage=鼠标按下且选中时的背景图片
CollapsedNodeImage=折叠节点的图片
Columns=列的集合
ColumnsCount=列的数量
ColumnType=列的类型
Cursor=光标
CustomFormat=自定义格式化字符串
Digit=保留小数的位数
DisabledBackImage=无效状态背景图片
DisableCheckedImage=无效状态选中背景图片
DisabledLinkColor=不可用的超链接颜色
DisplayOffset=偏移显示坐标
Dock=绑定边缘配置
Enabled=可用状态
ExpendedNodeImage=展开节点的图片
Focused=是否处于焦点状态
Font=字体
TextColor=前景色
Forzen=是否冻结列
GridLineColor=表格网格线的颜色
GroupName=组名称
HasPopupMenu=是否拥有弹出菜单
HeaderHeight=头部区域的高度
HeaderSize=页头的大小
HeaderVisible=是否显示头部
Height=高度
HorizontalOffset=横向偏移位置
HoveredBackImage=鼠标悬停时的背景图片
IsWindow=是否窗体
Layout=页头排列方式
LayoutStyle=控件排列方式
Left=距离容器左侧的位置
LineHeight=文字的行高
LinkBehavior=链接行为
LinkColor=链接颜色
LinkVisited=是否已被访问过
Location=控件的位置坐标
Margin=外边距
Maxinum=最大值
MaximumSize=最大尺寸
Mininum=最小值
MinimumSize=最小尺寸
Multiline=是否允许多行显示
MultiSelect=是否允许多选
Name=名称
NodeSize=节点的大小
Opacity=透明度
Padding=内边距
PasswordChar=密码文字
PushedBackImage=鼠标按下时的背景图片
ReadOnly=是否处于只读模式
Region=实际区域
ResourcePath=资源路径
RightToLeft=是否从右向左显示
RowsCount=行的数量
SelectedDay=选中的日期
SelectedIndex=选中模式
SelectedText=选中文字
SelectedValue=选中的值
SelectionBackColor=选中文字的背景色
SelectionTextColor=选中文字的前景色
SelectionMode=选中模式
ShadowColor=阴影的颜色
ShadowSize=阴影的大小
ShowHScrollBar=是否显示横向滚动条
ShowThousands=是否显示千分位
ShowVScrollBar=是否显示纵向滚动条
Size=尺寸大小
SplitMode=分割模式
SplitterPosition=分割线的位置
SplitterVisible=分割线是否可见
Step=数值变化单位
TabIndex=按下Tab键时的触发顺序
TabPages=页的集合
TabStop=是否允许按下Tab键时切换控件
TempText=提示文字
TempTextTextColor=提示文字的前景色
Text=文本
TextAlign=文字的位置
Top=距离容器上侧的位置
TopMost=是否置顶显示
UnCheckedImage=未选中时的图片
UseAnimation=是否使用动画效果
Value=数值
Vertical-Align=垂直排列方式
VerticalOffset=纵向偏移位置
Visible=是否可见
VisitedLinkColor=已访问超链接的颜色
Width=宽度
WordWrap=是否允许自动换行